+---+---+---+---+
|   |           |
+   +   +---+   +
|       |       |
+---+---+   +---+
|           |   |
+---+---+---+---+