+-+-+-+-+-+
| |       |
+ + +-+ + +
|   |   | |
+-+-+ +-+-+
|         |
+ +-+-+-+ +
| |       |
+ +-+-+ +-+
|     |   |
+-+-+-+-+-+